1,1,1,1,1,1,1,1,1,1,1,1,1,1,1,1,1,1,1,1,1,1,1,1,1,1,1,1,1,1,1,1,1,1,1,1,1,1,1,1,1,1,1,1,1
1,7,7,7,7,7,7,7,7,7,7,7,7,7,7,7,7,7,7,7,7,7,7,7,7,7,7,7,7,7,7,7,7,7,7,7,7,7,7,7,7,7,7,7,1
1,13,13,7,7,7,7,7,7,7,7,7,7,7,7,7,7,13,13,13,13,13,7,7,7,7,7,7,7,7,7,7,7,7,7,7,7,7,7,7,7,7,13,13,1
1,13,13,13,7,7,7,7,7,7,7,7,7,7,7,13,13,13,13,13,13,13,13,7,7,7,7,7,7,7,7,7,7,7,7,7,7,7,7,13,13,13,13,13,1
1,13,13,13,13,7,7,7,7,7,7,7,7,7,7,13,13,13,13,13,13,13,13,13,13,7,7,7,7,7,7,7,7,7,7,7,13,13,13,13,13,13,13,13,1
1,13,13,13,13,13,7,7,7,7,7,7,7,7,13,13,13,13,13,13,13,13,13,13,13,13,7,7,7,7,7,7,7,7,13,13,13,13,13,13,13,13,13,13,1
1,13,13,13,13,13,13,7,7,7,7,7,7,7,13,13,13,13,13,13,13,13,13,13,13,13,7,7,7,7,7,13,13,13,13,13,13,13,13,13,13,13,13,13,1
1,13,13,13,13,13,13,13,7,7,7,7,7,7,13,13,13,13,13,13,13,13,13,13,13,13,7,7,7,7,7,13,13,13,13,13,13,13,13,13,13,13,13,13,1
13,13,13,13,13,13,13,13,13,13,7,7,7,7,13,13,13,13,13,13,13,13,13,13,13,13,7,7,7,7,7,7,7,13,13,13,13,13,13,13,13,13,13,13,13
13,13,13,13,13,13,13,13,13,13,13,7,7,7,13,13,13,13,13,13,13,13,13,13,13,13,7,7,7,7,7,7,7,7,7,13,13,13,13,13,13,13,13,13,13
13,13,13,13,13,13,13,13,13,13,13,7,7,7,13,13,13,13,13,13,13,13,13,13,13,7,7,7,7,7,7,7,7,7,7,7,7,13,13,13,13,13,13,13,13
13,13,13,13,13,13,13,13,13,13,13,7,7,7,7,7,13,13,13,13,13,13,7,7,7,7,7,7,7,7,7,7,7,7,7,7,7,7,7,7,13,13,13,13,13
13,13,13,13,13,13,13,13,13,13,13,7,7,7,7,7,7,7,7,7,7,7,7,7,7,7,7,7,7,7,7,7,7,7,7,7,7,7,7,7,7,7,13,13,13
13,13,13,13,13,13,13,13,13,13,13,7,7,7,7,7,7,7,7,7,7,7,7,7,7,7,7,7,7,7,7,7,7,7,7,7,7,7,7,7,7,7,7,7,1
13,13,13,13,13,13,13,13,13,13,13,7,7,7,7,7,7,7,7,7,7,7,7,7,7,7,7,7,7,7,7,7,7,7,7,7,7,7,7,7,7,7,7,7,1
1,13,13,13,13,13,13,13,13,13,7,7,7,7,7,7,7,7,7,7,7,7,7,7,7,7,7,7,7,7,7,7,7,7,7,7,7,7,7,7,7,13,13,13,1
1,13,13,13,13,13,13,13,13,7,7,7,7,7,7,7,7,7,7,7,7,7,7,7,7,7,7,7,7,7,7,7,7,7,7,7,7,7,7,13,13,13,13,13,1
1,13,13,13,13,13,13,7,7,7,7,7,7,7,7,7,7,7,7,7,7,7,7,7,7,7,7,7,7,7,7,7,7,7,7,7,7,7,13,13,13,13,13,13,1
1,13,13,13,13,13,13,7,7,7,7,7,7,7,7,7,7,7,7,7,7,7,7,7,13,13,13,13,13,13,13,13,13,13,13,7,7,7,13,13,13,13,13,13,1
1,13,13,13,13,13,7,7,7,7,7,7,7,7,7,7,7,7,7,7,7,13,13,13,13,13,13,13,13,13,13,13,13,13,13,13,13,13,13,13,13,13,13,13,1
1,13,13,13,13,7,7,7,7,7,7,7,7,7,7,7,7,7,7,7,13,13,13,13,13,13,13,13,13,13,13,13,13,13,13,13,13,13,13,13,13,13,13,13,1
1,13,13,13,7,7,7,7,7,7,7,7,7,7,7,7,7,7,7,13,13,13,13,13,13,13,13,13,13,13,13,13,13,13,13,13,13,13,13,13,13,13,13,13,1
1,7,7,7,7,7,7,7,7,7,7,7,7,7,7,7,7,7,13,13,13,13,13,13,13,13,13,13,13,13,13,13,13,13,13,13,13,13,13,13,13,13,13,13,1
1,1,1,1,1,1,1,1,1,1,1,1,1,1,1,1,1,1,13,13,13,13,13,13,13,13,13,1,1,1,1,1,1,1,1,1,1,1,1,1,1,1,1,1,1
0,0,0,0,0,0,0,0,0,0,0,0,0,0,0,0,0,0,0,0,0,0,0,3,3,0,0,0,0,0,0,0,0,0,0,0,0,0,0,0,0,0,0,0,0
