14,14,14,14,14,14,14,14,3,3,3,3,3,3,3,14,14,14,14,14,14,14,14,14,14,14,14,14,14,14,14,14,14,14,14,14,14,14,14,14,14,14,14,14,14
14,14,14,14,3,3,3,3,3,3,3,3,3,3,3,3,3,3,3,3,14,14,14,14,14,14,14,3,3,3,3,3,3,3,3,14,14,14,14,14,14,14,14,14,14
14,14,14,14,3,3,3,3,3,3,3,3,3,3,3,3,3,3,3,3,3,3,3,3,3,3,3,3,3,3,3,3,3,3,3,3,3,3,3,14,14,14,14,14,14
14,14,14,3,3,3,3,3,3,3,3,3,3,3,3,3,14,14,14,14,14,3,3,3,3,3,3,3,3,14,14,14,14,14,3,3,3,3,3,3,3,3,14,14,14
14,3,3,3,3,3,3,3,3,3,3,3,3,3,3,3,14,14,14,14,14,3,3,3,3,3,3,3,3,14,14,14,14,14,3,3,3,3,3,4,3,3,3,14,14
14,3,3,3,3,3,3,3,3,3,3,3,3,3,3,3,14,14,14,14,14,3,3,3,3,3,3,3,3,14,14,14,14,14,3,3,3,3,3,3,3,3,3,14,14
14,3,3,3,3,3,3,3,3,3,3,3,3,3,3,3,3,14,14,14,3,3,3,3,3,3,3,3,3,3,14,14,14,3,3,3,3,3,3,3,3,3,3,14,14
14,3,3,3,3,3,3,3,3,3,3,3,3,3,3,3,3,3,3,3,3,3,3,3,3,3,3,3,3,3,3,3,3,3,3,3,3,14,14,14,3,3,3,14,14
14,3,3,3,3,3,3,3,14,3,3,3,3,3,3,3,3,3,3,3,3,3,3,3,3,4,3,3,3,3,3,3,3,3,3,3,3,14,14,14,3,3,3,14,14
14,3,3,3,3,3,14,14,14,14,3,3,3,3,3,3,3,3,3,3,3,3,3,3,3,3,3,3,3,3,3,3,3,3,3,3,3,14,14,3,3,3,3,3,14
14,3,3,3,3,3,14,14,14,14,3,3,3,3,3,3,3,3,3,3,3,3,3,3,3,3,3,3,3,3,3,3,3,3,3,3,3,14,14,3,3,3,3,14,14
14,3,3,3,3,3,14,14,14,14,3,3,3,3,3,3,3,3,3,3,3,3,3,3,3,3,3,3,3,3,3,3,3,3,3,3,3,3,3,3,3,3,3,14,14
14,3,3,3,3,3,14,14,14,3,3,3,3,3,3,3,3,3,3,3,3,3,3,3,3,3,3,3,3,3,3,3,3,3,3,3,3,3,3,3,3,3,3,14,14
14,3,3,3,3,3,3,3,3,3,3,3,3,3,3,3,3,3,3,3,3,3,3,3,3,3,3,3,3,3,3,3,3,3,3,3,3,3,3,3,3,3,3,3,14
14,3,3,3,3,3,3,3,3,3,3,3,3,3,3,3,3,14,14,3,3,3,3,3,3,3,3,3,3,3,3,4,3,3,3,3,3,3,3,3,3,3,3,3,14
14,3,3,3,3,3,3,3,3,3,3,3,3,3,3,3,14,14,14,14,3,3,3,3,3,3,3,3,3,3,3,3,3,3,3,14,14,14,3,3,3,3,3,3,14
14,3,3,3,3,3,3,3,3,3,3,3,3,3,3,3,14,14,14,14,3,3,3,3,3,3,3,3,3,3,3,3,3,3,3,14,14,14,3,3,3,3,3,3,14
14,3,3,3,3,3,3,3,3,3,3,3,3,3,3,3,3,14,14,14,3,3,3,3,4,3,3,3,3,3,3,3,3,14,14,14,14,3,3,3,3,3,3,3,14
14,3,3,3,3,3,3,3,3,3,3,3,3,3,3,3,3,3,3,3,3,3,3,3,3,3,3,3,3,3,3,3,3,14,14,14,14,3,3,3,3,3,3,14,14
14,3,3,3,3,3,3,3,4,3,3,3,3,3,3,3,3,3,3,3,3,3,3,3,3,3,3,3,3,3,3,3,3,14,14,14,14,3,3,3,3,3,3,14,14
14,3,3,3,3,3,3,3,3,3,3,3,3,3,3,3,3,3,3,3,3,3,3,3,3,3,3,3,3,3,3,3,3,14,14,14,14,3,3,3,3,3,3,14,14
14,3,3,3,3,3,3,3,3,3,3,3,3,3,3,3,3,3,3,3,3,3,3,3,3,3,3,3,3,3,3,3,3,3,3,3,3,3,3,3,3,3,3,3,14
14,14,3,3,3,3,3,3,3,3,3,3,3,3,3,3,3,3,3,3,3,3,3,3,3,3,3,3,3,3,3,3,3,3,3,3,3,3,3,3,3,3,3,3,14
14,14,14,14,14,14,14,14,14,14,14,14,14,14,14,14,14,14,14,14,3,3,3,3,3,3,3,14,14,14,14,14,14,14,14,14,14,14,14,14,14,14,14,14,14
0,0,0,0,0,0,0,0,0,0,0,0,0,0,0,0,0,0,0,0,0,0,0,3,3,0,0,0,0,0,0,0,0,0,0,0,0,0,0,0,0,0,0,0,0
